Ульпан Иврит

Введение в иврит

1. Алфавит и произношение

Иврит использует ивритский алфавит, состоящий из 22 букв. В нем нет заглавных и строчных букв, а также отсутствуют гласные (но иногда используются точки и черточки – "никад" – для обозначения гласных).

Вот основные буквы алфавита с их звучанием:

א (Алеф) – без звука (может передавать разные гласные)

ב (Бет) – "Б" (если есть точка внутри) или "В" (если без точки)

ג (Гимель) – "Г"

ד (Далет) – "Д"

ה (Хей) – "Х"

ו (Вав) – "В" (может обозначать "О" или "У" в некоторых словах)

ז (Зайн) – "З"

ח (Хет) – "Х" (глубокий звук, как "h" в "loch")

ט (Тет) – "Т"

י (Йуд) – "Й" (может обозначать "И")

כ (Каф) – "К" (или "Х" без точки)

ל (Ламед) – "Л"

מ (Мем) – "М"

נ (Нун) – "Н"

ס (Самех) – "С"

ע (Айн) – гортанный звук (почти немой)

פ (Пей) – "П" (или "Ф" без точки)

צ (Цади) – "Ц"

ק (Куф) – "К"

ר (Рейш) – "Р" (мягкий, похож на французский "r")

ש (Шин) – "Ш" (или "С" в зависимости от точки)

ת (Тав) – "Т"


2. Простые слова и фразы

Чтобы начать говорить на иврите, запомним несколько простых слов:

שלום (Шалом) – Привет / Пока / Мир

תודה (Тода) – Спасибо

כן (Кен) – Да

לא (Ло) – Нет

בבקשה (Бэвакаша) – Пожалуйста

סליחה (Слиха) – Извините

מה שלומך? (Ма шломха? / Ма шломэх?) – Как дела? (муж./жен.)

אני... (Ани...) – Я...

אני אנדריי (Ани Андрей) – Я Андрей


נעים מאוד (Наим меод) – Очень приятно


3. Простые предложения

Я учу иврит – אני לומד עברית (Ани ломед иврит) (муж.)
Я учу иврит – אני לומדת עברית (Ани ломедет иврит) (жен.)

Ты говоришь на иврите?

(муж.) אתה מדבר עברית? (Ата медабер иврит?)

(жен.) את מדברת עברית? (Ат медаберет иврит?)


Я понимаю немного иврит – אני מבין קצת עברית (Ани мевин кцат иврит) (муж.)
Я понимаю немного иврит – אני מבינה קצת עברית (Ани меvina кцат иврит) (жен.)

4. Знакомство с написанием

В иврите пишут справа налево, например:

שלום, אני אנדריי (Шалом, ани Андрей) – Привет, я Андрей


5. Задание для практики

Попробуй написать и сказать на иврите:

1. "Привет, меня зовут Андрей."


2. "Как дела?"


3. "Спасибо!"


4. "Я говорю немного на иврите."






